#####################################################################################################
#S    # #   #     # #     # #     # #       # #   #   # # #   # #     #       # # # # # # #     #   #
### ### ### ### ### ##### # ##### # ### ### # ### # ### # ### # ### ##### # ### # # # # # # # ### ###
#       # # #     #     #   # # #   #     # # #   #   #       #     # #   #   # #   #     # #       #
##### ### # ##### ### ##### # # # ### ####### ### # ####### ##### ### # ####### ### ### ### #########
#   #   #   # # # #     # #   #     #   # #   #     #   #   # #     # # #     # #   # # #           #
### ### # ### # # ##### # # ##### ### ### ### ##### # ##### # # # ### # # # ### ### # # # # # # #####
#   # #           #     #   # # # # #     #   # #   # # #   # # # #   # # # # # #   #     # # #     #
### # ### # ### # ##### # ### # # # ### ##### # # # # # ### # ### # ### # ### # ### # ### ##### #####
#         # #   #   #   # # # # # # # # #   # #   # # #   # #           # #   #   #     # # # # # # #
######### ######### ### # # # # # # # # ### # ##### # ### # # ### # ##### # ### ##### ##### # ### # #
# #     # # # #     #     # #       #     #   #   # # #   #     # #         #   # #   # #         # #
# ##### ### # # ### ##### # ##### ### ### ### # ### # ### # ################### # # ### ### # ##### #
#         #   # #       # # #     #     # # # # # #   #           #     # #   #     #     # #       #
##### ### ### ### ### # # # ##### # ####### # # # ### ##### # ####### ### # # # # ### ##### #########
# # # #     #     # # #           #     #   # #   # #     # # # #   #       # # #   #     # # #     #
# # # # # # ### ### ### # # # ### # # ### ### # ### ### ### ### # ### ### ##### # # # ##### # ### ###
#     # # #     #       # # # #     #   #     # #       #               #   #   # # #   # #     #   #
############# # # ### ####### ##### ### # # ### ##### ##### ################### ### # ### # ##### ###
# # # # #     # # #   # # #   #     # # # #   #   # #     #     # #   # # # # # #   # #             #
# # # # ############### # ######### # ####### ### # # ##### ##### # ### # # # # ##### # ####### #####
#   # # #   # # #       # # # # #   #     #   # # # #   # # #         # # # #                 #     #
### # # ### # # ####### # # # # ### # # ### ### # # # ### # ### ####### # # ### ##### # ##### #######
#         # # # #   #   #       #   # # # # #   # #   # # #     # #   # #   #     # # # #   #   # # #
##### ### # # # ### # ######### ### ### # # ### # # ### # # ##### # ### ### # ##### ##### ####### # #
# # # #           # # # #         #     #   # # # # # #       #     # # #       # #     # # #   #   #
# # ######### ### # # # ####### ####### ### # # # # # ### ### # # # # # ### ##### # ##### # # ### ###
#   #   # # #   #       #   #         # # # # #     # # #   #   # #       # #     #     # # # #   # #
# # # ### # ######### ##### # ##### ### # # # ##### # # # ### # ########### # ##### ### # # # # ### #
# #     #   # #         #       #     # #     # #     #     # # # # # # # #     #   # #         # # #
##### ##### # ##### ######### ##### # # ##### # # ####### ####### # # # # ### ##### # ####### ### # #
# # # # #   # # #       #   # # #   # #   #       #   # # # # # # #   #         # # # # #   # # # # #
# # # # # # # # ##### ### ##### ##### # # ##### ### # # # # # # # # ##### ##### # # # # # ### # # # #
# # #     #     # #   # # #       # # # #     # # # # # # # # #     # # # #   #     #   #   #     # #
# # ##### ##### # # ### # ####### # # ### ### # # ### # # # # # ##### # # # ######### ### ######### #
#   # #   #       #   #   #     # # #   # # #   # #     # # #       # #     #   #   # # # #   # #   #
### # ######### # # # # ### ##### # # ##### # # # ##### # # ### ##### ### ### ### ### # # # ### # ###
#     # #       #   #             # #       # # #   # #   # # #   # # # # # # # # #               # #
# ### # ####### ##### ### ####### # ### ### ### # ### # ### # ### # # # # # # # # # ############### #
# #       #   # #     #   # #     #     #   # # # # #   #   #         #   #   # #             # #   #
####### ### ############### ##### ######### # # # # ### # ### # ### # # ### ### # ########### # # ###
#   #   # # # # # #     #     # #   #       # # # #   # #   # # # # #   # #             #   #       #
# ##### # # # # # ### ####### # ### ##### ### # # ### # # ### ### ### # # # ############# # # ##### #
#   # #   # # #   #   # #   # # #     # #   #     # #     # #       # #         #   #     # #     # #
### # # ### # # ##### # ### # # ### ### # ##### ### # ### # # ##### # # # # # # # ### # # # # #######
#                   #         # # # #     #   # #   # # #       # # # # # # # #       # # # #       #
# ######### ##### ####### ### # # # ### # ### # # ### # ##### ### ### ##### # ### # # # # ######### #
# # # #     # # # #   # # #   # # # #   # #         # # # # #       #   # # #   # # # # # #     # # #
# # # ### ### # # # ### ##### # # # ##### ### ### ### # # # ### ######### ### ############# ### # ###
# #     # #   #   # #   # #             #     #       #       #           #     #   #         #     #
# # # # # ### # # # # ### ##### ##### ########### ##### # # ################# ### ### ##### #########
# # # #   #     #         #     # #   # #       #     # # # #     # #       #       # #   #   # #   #
####### ##### ##### ##### ####### ### # ####### # # ### ##### # ### # # ##### ####### # ####### # ###
# # #   #     #     #                     #       #           #       # #   #   # # #   # #   #   # #
# # ### ####### # # ####### # # ### ### ########### ######### ########### ####### # # ### # ##### # #
#       #       # # #       # # #   #       # # #         # #               #     #       # #   # # #
### # # ### # # ####### ########### # ##### # # ### ####### # ##### ### ### # ####### ##### # # # # #
#   # # #   # #   #   #   # #     # # #       # # #   #     #     #   #   #         #   #   # #   # #
# ### ##### # # ##### ##### # ### ####### # # # # # ### # ############### ########### ### # ##### # #
# #     #   # # # #         # # #     #   # # # #   #   #     #       # # #       # # # # # #       #
# # ### ######### ######### ### ##### ####### # # ### ######### # ### # ### ####### # # # ####### ###
# # # # # #   # #             #           #           #   #     #   #   # # #   #   # # # #     # # #
### # ### ### # ######### ### ### # # # ### # # ### ### ##### # ### ##### # # ##### # # # ### ### # #
# # # #                   #       # # # # # # # #       # # # # # # # #   #       # #               #
# ### ### ##### ### # ####### ##### ### # ######### ### # # # ### ### # # # # # ### ### ### ##### # #
# #         #   #   # #     # #     # #       # #     # #           #   # # # #   # #     #     # # #
# ##### ########### ####### ### # # # ####### # ### ##### ##### # ### ##### ####### # ###############
# #     #     # # # # #         # # #                         # #               #             #     #
# ### ### ### # # ### ########### ##### ### ### ### ##### ####### ### ##### ##### ### ##### ### #####
#     #   #         # #   # #     # #   # # #     #     #   #   # # # #   #       #       #         #
### # ### # ##### ### ### # ####### ##### # ### # # # # # # ### ### ### ### ######### ### # ### ### #
#   # #   # #                   # # #   #     # # # # # # #             #           #   # #   # # # #
######### ######### ########### # # ### # # # # # ### # ####### ### # ### ### ### # ### # # ##### # #
#       #   #   #     # # # #       #     # # # #   # #       #   # #   #   #   # #   # # #       # #
####### ####### ####### # # ####### ### # # # ### ##### # # # ######### ### ####### ### # ### #######
#         # # #   #   # # #             # # # #   #     # # # #       # # #     #   #   #   #     # #
# ### # ### # # ### ### # ####### # # # # # ####### ### ### ### ######### ##### ##### ### ##### ### #
# # # #       # #   #     # #     # # # # # #       #     #                   #   #   # # # #       #
### ######### # ### ##### # # # ####### ##### ####### # ### ####### # ################# # # ### #####
#           #   #   # #       # #         #       #   #   #       # #         #   # #   # # #       #
# ######### ### ### # ### ### ##### ### ### # ##### # # ### # ##### # ######### ### # ##### # # # ###
# # #                       # #     #     # # # #   # #   # #     # #       # # # # # # # # # # #   #
### # ####### # # ##### ##### # ##### # ##### # ### # ####### # ### ### ### # # # # # # # # ##### ###
#     #     # # # # #     #   #     # #     # #     #       # # # # # #   # #     # # #       #     #
##### ### # # ##### # ##### ### # # ### ##### ### ### # ### ### # ### # ##### ##### # # ######### ###
# #   #   #     #       #   #   # #   # #     #   #   #   #   #       # #       #         # #       #
# ### ####### ####### ######### ####### ### # ### # ####### # ####### ####### ### # # ### # #########
#       #     # #         # #     #     #   # #   #       # #       #             # #   #           #
### ##### ### # # ### ##### ### ##### ####### ##### # # ##### # # # ####### ### ##### # ##### # # # #
#   # # # #   #   #   # #           #   #   # #     # #     # # # #     #     #   # # #     # # # # #
##### # ### ### ### # # # ##### ### # # ### ######### ####### # # # # ### ####### # # ##### # # #####
# #           # #   #   #   #     # # # #                   # # # # #   # #         #     # # # # # #
# # ####### ##### ### # ####### # ### ##### ### ### # # ### # ### ############### # ### # ### # # # #
#   # # #     # #   # #   #     #   # # #   #   # # # #   # # #         #       # #   # # #   #     #
# # # # ### ### ##### # ### ### ####### ######### # ######### ### ### ### ####### # # ####### #######
# # #           #     # # # # #     #   #       #           #   # #       # #   # # #       #       #
########### # # ### # # # ### # # ##### ####### ### # ##### ### # # ##### # # ### # # ######### #####
#       #   # # #   # # #       # #   #             #     #   # # #     #       # # #       #       #
# # # # # # # ##### ### ##### # # ### ### # # ##### ### ####### ##### # # # # ### # # # # # ### # # #
# # # #   # #     # #   #     # # #       # # #       #       #   #   # # # #   # # # # # # #   # #E#
#####################################################################################################