#########################################################################
#   #               #               #     #     #                   #E# #
# ### ########### ##### ##### ########### # ####### ####### ####### # # #
#               #       # # #         # #         # #   # # #       # # #
######### # ## ########## # ######### # ##### # # # # # # # ######### # #
# #     # # #               #           # # # # #   # # #           # # #
# # ## ############## # ### # ########### # ##### ##### ########### # # #
# # #               # # # # #     # #           #           #       # # #
# # ############# # ##### # ##### # # ######### ######### # # ####### # #
#           #     # # # #       # # #       #         # # # #           #
# ####### ####### # # # ####### # # ########### ##### # # ###############
#       #     # # # # # #       #     # #       #   #   #       #       #
#############   # ### # # ########### # # #####   ### ######## ###### ###
#           # # #           #       # # #     # #   #       #           #
# # ####### # ############# ###### ## # ##### # ##### ############### # #
# # #       #     #   # #           #       # # # # #               # # #
# # # ########### # # # ##### # ########### # # # # ############### # # #
# # #           # # # # # # # # #           #               # # #       #
# # ######### # # # # # # # ##### ########### ############ ## # #########
# # #       # # #   #           #           #   #       #               #
# # # ####### ######## ######## ########### ##### ##### ########### ### #
#S# #                   #           #               #               #   #
#########################################################################