###########
#        E#
#    #    #
#    #    #
#         #
#S        #
###########