#####################
#     # #           #
# # ### ### ### # ###
#S# # # #   #   #   #
### # # ### # ##### #
#         # # #     #
##### # # ####### # #
#     # #         # #
##### ### ##### ### #
#     #   #     #   #
# ### # ### # # # # #
# #   # #   # # # # #
##### ##### ##### ###
#   # #   # # #   # #
### ##### ### ### # #
#     #       #     #
##### # ### # # # ###
#       #   #   #   #
# # ### # ### ### ###
# # #   # #   #    E#
#####################