######################################
# #   #          #      #        ###E#
# # # ## ######### ###  #### # #     #
# # #  #         # # ##      # # #####
# # ## ######### # #  #### ##### #   #
# #  #         # # ##            # # #
# ## ### #####   #  ############ # # #
#            ### ## #            # # #
############   #    # ########## # # #
#          ### # #### #        # # # #
# ######## ### # #    # ######       #
#        ###   # # ###       #########
########     ### # # # #####         #
#       # #### #           ######### #
# #####        # #########           #
#     ########## #       ## ##########
# # #            # # # #             #
# # ###### # ##### # # ############# #
#S#      # #       # #               #
######################################