#########################################################################################################################
#S  #     #     #     #     #   # #         #         #       #   #     #   #       # #   #   #                         #
### # ### # # ### # ### ### # # # # ####### ####### # ##### ### # # ### # # ### ### # # ### # ### ########### ######### #
#   #   # # # #   # #   # # # # # #     #   #     # #   #   #   # # #   # #   # #   # #   # #     #           #   #   # #
# ##### # # # # # # # ### # # # # ##### # ### ### # ### # ### ### # # # # ### # # ### ### # ####### ########### # # # # #
# #     #   # # # #     # #   # #       #     # #   #       #   # # # # #   #   #   #     # #       #   #   #   # # #   #
# # ####### # # # ### # # ##### # ############# ##### ##### ### # # # # ### ####### # ##### ### ##### # # # # ### # #####
#   #     # # # # #   #   #   # # #   #             #     #   # # # # # # # #   #   # #   #   #   #   # # # # # # # #   #
##### ### ### # ### ##### ### # # # ### # ####### ####### ### ### # ### # # # # # ### # # ### ### # ### # # # # # # # ###
#     # #     # #   #   #     #   #     # #     #   #       #   # #   # # # # # #       # # # # # # #   # #     #   #   #
# # ### # ##### # ### # ######### ####### # ### ### # ######### # ### # # # # # ######### # # # # # # ### ############# #
# #   # # #     #     #     #   # #     # #   # #   # #       # # #   #   # # #       #   # #   #   #   #     # #       #
# ##### # # ############### ### # # ### # ### # # ### # ##### # # # # ##### # ####### # ### ### # ##### ##### # # # ### #
#       # #       # #   #   #   # # #   #     # # #   # #     #   # # #   # #     #   #   # #   #     # #   # #   # #   #
######### ####### # # # # ### ### # # ########### # ### # ##### # ### # # # ##### ####### # # ####### # # # # ##### # ###
#       #   #   # #   #   #   #   # #   #     #   # # # # #   # #   #   #       # #     #   # #     # # # # # #     #   #
# ####### # # ### ######### ### ####### # ### # ### # # # ### # ### ### ####### # # ### ### # # ### # # ### # # ####### #
#         #       # #     #     #     # # # # #     #   #   #   #     #   #     #   #   #   #   #   # #     # # #     # #
######### ### # ### # ### ##### ##### # # # # ### ######### ######### ### # ######### ### ####### ########### # # ### # #
#     #   #   # #   #   #             #   # #     #   #   #     #       # # #     #     #   #   # #           # # # # # #
# ##### ### ##### ### # # ##### ########### ### ### # # # ##### # ####### # # ### ##### ##### # # # ####### ### # # # # #
#         # #   # #   # #     #   #   #   # #   #   #   # #     #   #     # # #   #   # #   # #   #     # #     # # #   #
######### # ### # ### # ######### ### # # # # ### ####### ### ##### # ####### # ### # # # # # ### ##### # ####### # #####
#     #   #     #   # # #   #     #   # # # #           #     #   # # #     # #   # #   # # # #   #   # #       #   #   #
# ### ############# # # # # # ##### ### # # ########### ####### # # # # ### # ### # ##### # # # ##### # ####### ##### # #
# # #   #         # # # # # #   # # #   # #   #         #       # # # # #   # # #     #   #   #       #   #     #   # # #
# # # # ### ##### # ### # # ### # # # ####### # ######### ####### # # # # ### # ### # # # ############### # ### # # ### #
# # # #       #   #     # #     #   #       #   #         #     #       # #   #     #   # #   #           # #   # # #   #
# # ### ####### ####### # ##### # ####### # ##### ######### ### ### # ### # # ############# # # ########### # ### # # ###
# #   #   #     #       #     # # #   #   # #     #     #   # #     # # #   #   #     #     #   #         # #     # # # #
# ### ### # ##### ########### # # # # ##### # ##### # ### ### ####### # ######### ### ### ####### ##### # # ####### # # #
#   #     #   # #           # #   # #   #   #     # #     #       # #   #   #     # #     #   #   #   # # # #       # # #
### ######### # ############# ##### ### # ### ### ### ########### # ##### # # ##### ##### ### # ##### # # # # ####### # #
# # #       #   #                   # # #   #   #   # # #     #   #   # # #       # #   # #     # #   # # # #   #     # #
# # ### ### ##### ############# ##### # ### ### ### # # # ### # ##### # # ####### # # # # # # ### # ### # # ### ### ### #
#     #   # #     #   #       # #     # #     #   # #     # # # #     #   #       # # # #   #   # #     #   # #         #
### # ### ### ##### # # ### # # # ### # ##### ##### ####### # # # ### ##### ####### # # ####### # ########### ##### ### #
#   #         #     # #   # #   #   # #     # #     #     #   #     # # #   #       # # # #     #   #     #   #     # # #
# ############# ######### # ####### # # ### # # ##### ### ##### ##### # # ### ### ### # # # ##### # # # # # ### ### # # #
# #       #     #         #   #     # #   # # # #     #   #     #       # #   #   #   #   #       # # # #   #   #   #   #
# # ##### # ### # ##### ##### ####### ### # # # # ##### ### ##### ####### # ### ### ############### ### ##### ######### #
# # #     # #     #   # #     #     # #   # # # #   # # #   #   # #   # # #   # #   #   #       #     # #     #     #   #
# ### ####### # ##### ### ##### # ### # ##### # ### # # # ### # # ### # # ##### # ### # ### ### # ### # # ######### # ###
#   #   #     # #   # #     # # #     #       # #   #   # #   # #   #   #     # #   # # #   # #   #     #           #   #
### # # # ##### ### # # ### # # ############### # ####### ### # ### ### # ### # ### ### # # # ##### # ######### ####### #
#     # # #     #     # #   #         # #   #   # #         # # #   #   #   #     #       # # #   # #   #     # #       #
# ####### ####### ####### # ### ##### # # # # ### # ##### # ### # ### ########### ##### ##### # ### ### # ##### # #######
#   #   # #     #   #     #         # # # # # #   #   #   # #   # #   #     #   #   # #   #   #     #   # #     #     # #
### # # # # ### ### # ####### ##### # # # # # # ####### ### # ### # ####### ### ### # ### # ##### ### ### # ######### # #
#   # #   # #   # # #   #   # #   # #   # # #       #   #   # #     #     #   # #   #       #   #   # # #   #           #
# ### ##### # ### # ### ### # ### ##### ### ### # # # ### ### # # ##### # ### # ############# # ##### # ##### ###########
#   # #     # # # #   #     # #   #   #     #   # #   # #     # #       #   # #   #     #   # #       # #       #   #   #
### # # ##### # # # # ####### # # # ### ##### ######### ### ### ########### # ### # ### # # # ######### # ####### # # # #
# # #   #     # # # #       #   # #     #           # #     #   #   #   # #     # #   # # # #   #   #   #       # # # # #
# # ##### ##### # # ####### ####################### # # ##### ##### ### # ### # # ### ### ### ### # # ######### # # ### #
#     #   #       # #       #     #     #       #   # #     #     #   # # #   #   #     #     #   # # #           #   # #
####### ### ### ### # ####### ### ##### # ### # # ### ##### ##### ### # # ### ##### ### # ##### ### # ############### # #
#             #   # #     #   # #         # # # #   # #     #   #   # #         #   #   # #   #   # #         #   # #   #
# ########### ### # ####### ### ########### # ##### # # ##### # ### # ####### # # ### ### # # ### # ######### # # # ### #
# #     #     #     #   #   #   #     #   # #       #   #   # #     # #       # #   # # # # #     #     #   # # # # #   #
# # ### # # ##### ##### # ### ### ### ### # ############# # # ####### # ####### # ### # # # ########### # ### ### # # ###
#   #   # #     # #   # # #       #   #   # #     #     # # #   #   #   #     # # #   #   # #       #   #         #   # #
##### ####### # # ### # # ### ##### ### ### # ### # ### # ### ### # ##### ### # # # ####### # ##### # ######### ####### #
# #   #   #   # #     #       #     #       #   # #   # #   #   # # #       # #   # #       #     # # #       # #     # #
# # ### # ##### ### ########### ##### # ####### # # ### ### ### # ### ####### ##### # ### ####### # # # ##### # ##### # #
#   #   #     # #   #     #   #       #     #   #   #     #     # #   #   #     #   # # # #       # # # # #   #   #     #
##### ####### # # ### ### # # ############# # ####### ######### # # ### ### ### # ### # # # ####### # # # # # ### # # ###
#   #   #   #   # #   # # # #     #   #   # #   #     #   #   # # #   #     #   #   # # #   #     # # # #   # #   # # # #
# ##### # # ### # # ### # # ##### # # # ### ### # ####### # # # # # # ####### ### # # # ##### ### # # # ##### # ##### # #
# #       # # # #   #   # #   #   # # #     #   # #       # # # # # #   #     #   # #       # # #   #   #             # #
# # ####### # # ##### ### ### # ##### ####### ### ####### ### # # # ### # ##### ####### ##### # ########### # ######### #
#   #       #   #   #     #   #       #     # # #   # #       # # #   # #   #   #   #   #   #         # #   #   #     # #
##### ########### ######### ### ####### ### # # ### # # ####### # ### # ### ##### # # ### # ######### # # ##### # ### # #
#     #     #   #   #   #   #   #       # # # #     # #         #     # # #   #   # # #   #           # # #   # #   # # #
# ##### ### # # ### # # # ####### ####### # # ####### ################# # ### # ### # ### ############# # ### # ##### # #
# #   #   #   # #   # #   #   #   #         # # #   #   #   #   #   # #   # # #   # #   #     #   #     #   # #       # #
# # # ### ##### # # # ##### # # ### ######### # # # ### # # # # ### # ##### # ##### # # ### ### # # ####### # ### # ### #
#   # #   #   #   #   #     # #   #     #     #   #   #   # # # #     #     #     # # # #   #   # #   #   # # #   # #   #
##### # ### ########### ##### ### ##### # ########### ##### # # # # ### ### ##### # ### # ### ### # # # # # # # ### ### #
#     # # #   #             #     #   #   #       #   #   #   #   #   # # # #   # # #   # #   #     # # # # #   # #     #
# ##### # ### # ####### ########### # # ### # ##### ### # ### ####### # # # # # # # # ### ##### # ### # # # ##### # #####
#     #   #   #   #     #   #       #   #   #   #   #   #   #   #   # # # # # #   # #   #     # # #   # #   #   #       #
##### # ### ##### ### ### # # ########### ##### # ### ##### ### # # ### # # # ##### # # ##### ### # ########### ####### #
#     #         #   # #   # #   #   #         #   # # #     # #   #   #   # #   #   # # #   #     #       #   #   #   # #
# ############# ### # # ### ### ### # ### ### ##### # # ##### ####### ### # ### # ##### ### # ######### # ### ### ### # #
#     #   #     #   #   #   # # #   # #   #   #       #   #         #   # #   # # #   # #   # #         #     # #   # # #
# # ### # # # ### ######### # # # ### ##### ### ### ##### ######### # ### # ### # # # # # ##### ######### ##### ### # ###
# #     # # # #       #     #   # #   #   #   #   # #   # #   #     #   # #     # # #   #   #   #     #   #   # #   #   #
# ##### # # ### ##### # ######### # ### # ### # # ### # # # # # ####### # ####### ### ### # # ### ##### # ### # ### ### #
# #   # # #   #     # #   #     # # # # # #   # #   # #   # #   # #   # # # #           # # #         # # #   # #     # #
# # # # # ### ####### ### ### # # # # # # # ####### # ##### # ### # # # # # # ########### # ######### # ### # # # # # # #
#   # # #   #   #     #       # # #   # # #       # # #   # #       # #   # #           # #     # #   #     #   # # #   #
##### ##### ### # ##### ######### ##### # ### ### # # ### # ######### # ### ########### ##### # # # ########### # # # ###
#     #   #   # # #   # #     #   #     # #   #   # #   # # #       #   #     #       # #   # #     #   #       # # #   #
# ##### # ### # # # # # # ### # ### ##### # ### ### ### # # # ##### # ##### ### ##### # # # ##### ##### ### ##### # #####
#     # #   # # #   # # #   # #   #   #     # #   #   #   # # #     # #   # #       # #   #     # #   # #   #   # #     #
####### # ### # ##### # ### # # # ### # ##### ### ### ##### # ####### # # # # ####### ######### # ### # # # ### # ##### #
#       # #   #     # #   # #   #     # #   #         #   #   #       # # # #       #   #   #   #   # #   # #       #   #
# # ##### # ####### # ### # ####### ### # # # ### ##### # ##### # ##### # # ####### ### # ### ##### # ##### # ##### ### #
# #     # #   #     #   # #     #   #   # # #   #     # #       #   #   #         # # # #   # # #   #     # #   #   #   #
### ##### ### # ####### # ### # # ### ##### ######### # # ########### ##### ### ### # # # # # # # ####### ####### ### ###
#   #   #     #   #     #   # # #   #     # #     # #   # #         #     #   #   # #     # # # #     #   #     # #   # #
# ### # ######### # ####### # ########### # # ### # ##### # ##### # ##### ### ### # ### ### # # # ### ### # ### # # ### #
# #   # #     #   #   #   #     #     # #   #   # # # #     #     # #   #   # #     # #   # # # #   #   # # #   # # # # #
# # ### # ### # ##### ### ### # # ### # ####### # # # # ##### ##### ### ### # ####### ### # # # ### ### # # # ### # # # #
# #   #   #   #   #   #   #   # # #   #     #   #     #   #   #   # #       #   #   #     #   #       # # # # #   #   # #
# ### ##### ##### # # # ### ### # # ### ##### ##### ##### ##### # # # ######### # # ############### # ### # # # ##### # #
#     #       #   # # #     #   # #   # #     #   # #   #     # # # #   #   #     # #     # #       #     # # # #   # # #
### ####### # ### ### ####### # # ### # # ##### ### # ####### # # # ### # # # # ##### # # # # ############# # # # ### # #
#   #       # #     # # #     #   # # #   #     #   #   #   # # # #     # # # # #     # #   #   #   #   #   #   #   # # #
##### ######### ### # # # ####### # # ### # # ### ##### # ### # # # ##### # # # # # ### ### ### ### # # # ######### # # #
#     #   #   #   # # #   #       #   #   # #   #     # # #   # # # #   # #   #   #   # #     #       #   #       #   # #
# ##### # # # ### # # ##### ######### # ### ### # ### # # # ### # ### ### ############# # ######### ########### # ##### #
#   #   #   #     #     # #     #   # #   #   #   #     #     # #   #           #       # #   # #   #           #   #   #
### # ##### ########### # ##### # # ##### ### ####### ##### # ##### ##### ##### ######### # # # # ### # ########### # ###
# # # #     #           # #     # # #   # #     #   #       # #     #   #   #     #   # # # # # #     # #         # # # #
# # # # ##### ########### # ##### ### # ### ##### # ######### # ### # ####### ### ### # # ### # ####### ### ####### # # #
# #   # #   #       #   #   #   #     #     #     #   # #   # # #   #         # # #   # #     #   #       # #         # #
# ##### # # ####### ### ##### # ############# ####### # # # # # ######### # ### # # ### ##### ### ####### # # ##### # # #
#       # #             #     #               #           #   #           #   #   #             #         #   #     #  E#
#########################################################################################################################